full_name,age,league,season,position,Current Club,minutes_played_overall,minutes_played_home,minutes_played_away,nationality,appearances_overall,appearances_home,appearances_away,goals_overall,goals_home,goals_away,assists_overall,assists_home,assists_away
Aaron Cresswell,31,Premier League,2018/2019,Defender,West Ham United,1589,888,701,England,20,11,9,0,0,0,1,1,0
Aaron Lennon,33,Premier League,2018/2019,Midfielder,Burnley,1217,487,730,England,16,7,9,1,1,0,1,1,0
Aaron Mooy,30,Premier League,2018/2019,Midfielder,Huddersfield Town,2327,1190,1137,Australia,29,15,14,3,1,2,1,0,1
Aaron Ramsey,30,Premier League,2018/2019,Midfielder,Arsenal,1327,689,638,Wales,28,14,14,4,2,2,6,5,1
Aaron Rowe,20,Premier League,2018/2019,Forward,Huddersfield Town,69,14,55,England,2,1,1,0,0,0,0,0,0
Aaron Wan-Bissaka,23,Premier League,2018/2019,Midfielder,Crystal Palace,3135,1605,1530,England,35,18,17,0,0,0,3,1,2
Abdelhamid Sabiri,24,Premier League,2018/2019,Midfielder,Huddersfield Town,49,0,49,Morocco,2,0,2,0,0,0,0,0,0
Abdoulaye Doucouré,28,Premier League,2018/2019,Midfielder,Watford,3062,1566,1496,France,35,18,17,5,3,2,6,2,4
Aboubakar Kamara,26,Premier League,2018/2019,Forward,Fulham,687,468,219,France,13,8,5,3,1,2,0,0,0
Adalberto Peñaranda Maestre,23,Premier League,2018/2019,Forward,Watford,0,0,0,Venezuela,0,0,0,0,0,0,0,0,0
Adam David Lallana,32,Premier League,2018/2019,Midfielder,Liverpool,465,189,276,England,13,6,7,0,0,0,0,0,0
Adam Masina,27,Premier League,2018/2019,Defender,Watford,1003,463,540,Italy,14,7,7,0,0,0,1,1,0
Adam Smith,29,Premier League,2018/2019,Defender,AFC Bournemouth,2073,1051,1022,England,25,12,13,1,1,0,1,0,1
Adama Diakhaby,24,Premier League,2018/2019,Forward,Huddersfield Town,551,345,206,France,12,8,4,0,0,0,0,0,0
Adama Traoré Diarra,25,Premier League,2018/2019,Midfielder,Wolverhampton Wanderers,890,315,575,Spain,29,12,17,1,0,1,1,1,0
Ademola Lookman,23,Premier League,2018/2019,Forward,Everton,601,334,267,England,21,11,10,0,0,0,2,2,0
Adrian Mariappa,34,Premier League,2018/2019,Defender,Watford,1921,841,1080,Jamaica,26,12,14,0,0,0,0,0,0
Adrián San Miguel del Castillo,34,Premier League,2018/2019,Goalkeeper,West Ham United,0,0,0,Spain,0,0,0,0,0,0,0,0,0
Adrien Sebastian Perruchet Silva,32,Premier League,2018/2019,Midfielder,Leicester City,88,8,80,Portugal,2,1,1,0,0,0,0,0,0
Ainsley Maitland-Niles,23,Premier League,2018/2019,Midfielder,Arsenal,985,462,523,England,16,7,9,1,0,1,1,0,1
Alberto Moreno,28,Premier League,2018/2019,Defender,Liverpool,155,90,65,Spain,2,1,1,0,0,0,0,0,0
Aleksandar Mitrović,26,Premier League,2018/2019,Forward,Fulham,3282,1616,1666,Serbia,37,18,19,11,8,3,3,2,1
Alex Iwobi,24,Premier League,2018/2019,Forward,Arsenal,1972,742,1230,Nigeria,35,18,17,3,1,2,6,3,3
Alex McCarthy,31,Premier League,2018/2019,Goalkeeper,Southampton,2250,1170,1080,England,25,13,12,0,0,0,0,0,0
Alex Oxlade-Chamberlain,27,Premier League,2018/2019,Midfielder,Liverpool,19,19,0,England,2,2,0,0,0,0,0,0,0
Alex Pritchard,27,Premier League,2018/2019,Midfielder,Huddersfield Town,2092,992,1100,England,30,14,16,2,1,1,0,0,0
Alex Smithies,31,Premier League,2018/2019,Goalkeeper,Cardiff City,0,0,0,England,0,0,0,0,0,0,0,0,0
Alexander Sørloth,25,Premier League,2018/2019,Forward,Crystal Palace,173,121,52,Norway,12,8,4,0,0,0,0,0,0
Alexandre Lacazette,29,Premier League,2018/2019,Forward,Arsenal,2503,1403,1100,France,35,19,16,13,9,4,8,4,4
Alexandre Nascimento Costa Silva,24,Premier League,2018/2019,Forward,West Ham United,17,0,17,Portugal,1,0,1,0,0,0,0,0,0
Alexis Sanchez,32,Premier League,2018/2019,Forward,Manchester United,877,387,490,Chile,20,10,10,1,1,0,3,0,3
Alfie Jones,23,Premier League,2018/2019,Defender,Southampton,0,0,0,England,0,0,0,0,0,0,0,0,0
Alfie Mawson,27,Premier League,2018/2019,Defender,Fulham,1131,547,584,England,15,8,7,0,0,0,0,0,0
Alfie Whiteman,22,Premier League,2018/2019,Goalkeeper,Tottenham Hotspur,0,0,0,England,0,0,0,0,0,0,0,0,0
Ali Koiki,20,Premier League,2018/2019,Defender,Burnley,0,0,0,England,0,0,0,0,0,0,0,0,0
Alireza Jahanbakhsh,27,Premier League,2018/2019,Forward,Brighton & Hove Albion,1022,494,528,Iran,19,9,10,0,0,0,0,0,0
Alisson Becker,28,Premier League,2018/2019,Goalkeeper,Liverpool,3420,1710,1710,Brazil,38,19,19,0,0,0,0,0,0
Alvaro Morata,28,Premier League,2018/2019,Forward,Chelsea,943,530,413,Spain,16,8,8,5,3,2,0,0,0
Ander Herrera,31,Premier League,2018/2019,Midfielder,Manchester United,1404,617,787,Spain,22,10,12,2,0,2,3,3,0
André Filipe Tavares Gomes,27,Premier League,2018/2019,Midfielder,Everton,1986,972,1014,Portugal,27,13,14,1,1,0,1,1,0
Andre Gray,29,Premier League,2018/2019,Forward,Watford,1358,809,549,England,29,15,14,7,5,2,2,2,0
André Schürrle,30,Premier League,2018/2019,Midfielder,Fulham,1650,829,821,Germany,24,12,12,6,3,3,0,0,0
André-Frank Zambo Anguissa,25,Premier League,2018/2019,Midfielder,Fulham,1518,587,931,Cameroon,22,10,12,0,0,0,0,0,0
Andreas Christensen,24,Premier League,2018/2019,Defender,Chelsea,615,360,255,Denmark,8,4,4,0,0,0,0,0,0
Andreas Pereira,25,Premier League,2018/2019,Midfielder,Manchester United,595,521,74,Brazil,15,10,5,1,1,0,1,1,0
Andrew Robertson,27,Premier League,2018/2019,Defender,Liverpool,3219,1599,1620,Scotland,36,18,18,0,0,0,11,9,2
Andrew Surman,34,Premier League,2018/2019,Midfielder,AFC Bournemouth,1438,526,912,England,18,7,11,0,0,0,0,0,0
Andriy Yarmolenko,31,Premier League,2018/2019,Forward,West Ham United,459,269,190,Ukraine,9,5,4,2,0,2,0,0,0
Andros Townsend,29,Premier League,2018/2019,Midfielder,Crystal Palace,3018,1571,1447,England,38,19,19,6,2,4,4,2,2
Andy Carroll,32,Premier League,2018/2019,Forward,West Ham United,454,180,274,England,12,6,6,0,0,0,0,0,0
Angel Gomes,20,Premier League,2018/2019,Midfielder,Manchester United,25,25,0,England,2,2,0,0,0,0,0,0,0
Angelo Ogbonna,32,Premier League,2018/2019,Defender,West Ham United,1870,956,914,Italy,24,12,12,1,1,0,1,1,0
Angus Gunn,25,Premier League,2018/2019,Goalkeeper,Southampton,1080,540,540,England,12,6,6,0,0,0,0,0,0
Anthony Driscoll-Glennon,21,Premier League,2018/2019,Defender,Burnley,0,0,0,England,0,0,0,0,0,0,0,0,0
Anthony Knockaert,29,Premier League,2018/2019,Midfielder,Brighton & Hove Albion,1832,982,850,France,30,16,14,2,1,1,6,5,1
Anthony Martial,25,Premier League,2018/2019,Forward,Manchester United,1623,743,880,France,27,11,16,10,4,6,2,1,1
Antonio Barreca,26,Premier League,2018/2019,Defender,Newcastle United,4,0,4,Italy,1,0,1,0,0,0,0,0,0
Antonio Rüdiger,28,Premier League,2018/2019,Defender,Chelsea,2874,1350,1524,Germany,33,15,18,1,1,0,0,0,0
Antonio Valencia,35,Premier League,2018/2019,Defender,Manchester United,466,196,270,Ecuador,6,3,3,0,0,0,0,0,0
Arijanet Muric,22,Premier League,2018/2019,Goalkeeper,Manchester City,0,0,0,Montenegro,0,0,0,0,0,0,0,0,0
Aron Einar Gunnarsson,31,Premier League,2018/2019,Midfielder,Cardiff City,2274,1240,1034,Iceland,28,14,14,1,1,0,1,1,0
Arthur Masuaku,27,Premier League,2018/2019,Defender,West Ham United,1756,822,934,France,23,11,12,0,0,0,1,1,0
Artur Boruc,41,Premier League,2018/2019,Goalkeeper,AFC Bournemouth,1080,540,540,Poland,12,6,6,0,0,0,0,0,0
Ashley Barnes,31,Premier League,2018/2019,Forward,Burnley,2400,1307,1093,England,37,19,18,12,6,6,2,1,1
Ashley Westwood,31,Premier League,2018/2019,Midfielder,Burnley,2822,1530,1292,England,34,18,16,2,0,2,7,2,5
Ashley Young,35,Premier League,2018/2019,Midfielder,Manchester United,2568,1207,1361,England,30,14,16,2,1,1,2,2,0
Asmir Begović,33,Premier League,2018/2019,Goalkeeper,AFC Bournemouth,2160,1080,1080,Bosnia and Herzegovina,24,12,12,0,0,0,0,0,0
Aymeric Laporte,26,Premier League,2018/2019,Defender,Manchester City,3057,1526,1531,France,35,17,18,3,0,3,3,3,0
Ayoze Perez,27,Premier League,2018/2019,Forward,Newcastle United,2929,1526,1403,Spain,37,19,18,12,9,3,2,1,1
Bakary Sako,32,Premier League,2018/2019,Midfielder,Crystal Palace,25,8,17,Mali,4,3,1,0,0,0,0,0,0
Bakayo Sako,0,Premier League,2018/2019,Midfielder,Arsenal,7,7,0,England,1,1,0,0,0,0,0,0,0
Ben Chilwell,24,Premier League,2018/2019,Defender,Leicester City,3240,1620,1620,England,36,18,18,0,0,0,4,1,3
Ben Davies,27,Premier League,2018/2019,Defender,Tottenham Hotspur,1839,916,923,Wales,27,13,14,0,0,0,0,0,0
Ben Foster,37,Premier League,2018/2019,Goalkeeper,Watford,3420,1710,1710,England,38,19,19,0,0,0,0,0,0
Ben Gibson,28,Premier League,2018/2019,Defender,Burnley,63,63,0,England,1,1,0,1,1,0,0,0,0
Ben Hamer,33,Premier League,2018/2019,Goalkeeper,Huddersfield Town,553,283,270,England,7,4,3,0,0,0,0,0,0
Ben Mee,31,Premier League,2018/2019,Defender,Burnley,3420,1710,1710,England,38,19,19,0,0,0,2,1,1
Ben White,23,Premier League,2018/2019,Defender,Brighton & Hove Albion,0,0,0,England,0,0,0,0,0,0,0,0,0
Ben Wilmot,21,Premier League,2018/2019,Defender,Watford,26,0,26,England,2,0,2,0,0,0,0,0,0
Benjamin Johnson,21,Premier League,2018/2019,Forward,West Ham United,63,0,63,England,1,0,1,0,0,0,0,0,0
Benjamin Mendy,26,Premier League,2018/2019,Defender,Manchester City,900,450,450,France,10,5,5,0,0,0,5,3,2
Beram Kayal,32,Premier League,2018/2019,Midfielder,Brighton & Hove Albion,934,494,440,Israel,18,9,9,1,0,1,1,1,0
Bernard Anício Caldeira Duarte,28,Premier League,2018/2019,Midfielder,Everton,2128,960,1168,Brazil,34,16,18,1,0,1,3,1,2
Bernardo,25,Premier League,2018/2019,Defender,Brighton & Hove Albion,1750,990,760,Brazil,22,11,11,0,0,0,1,1,0
Bernardo Silva,26,Premier League,2018/2019,Midfielder,Manchester City,2853,1470,1383,Portugal,36,18,18,7,2,5,7,4,3
Bernd Leno,29,Premier League,2018/2019,Goalkeeper,Arsenal,2835,1395,1440,Germany,32,16,16,0,0,0,0,0,0
Bobby Reid,28,Premier League,2018/2019,Midfielder,Cardiff City,1422,725,697,England,27,11,16,5,4,1,2,1,1
Brian Murphy,37,Premier League,2018/2019,Goalkeeper,Cardiff City,0,0,0,Republic of Ireland,0,0,0,0,0,0,0,0,0
Bright Enobakhare,23,Premier League,2018/2019,Forward,Wolverhampton Wanderers,0,0,0,England,0,0,0,0,0,0,0,0,0
Bruno Écuélé Manga,32,Premier League,2018/2019,Defender,Cardiff City,3375,1710,1665,Gabon,38,19,19,0,0,0,1,1,0
Bruno Saltor Grau,40,Premier League,2018/2019,Defender,Brighton & Hove Albion,1136,534,602,Spain,14,6,8,0,0,0,1,1,0
Caglar Söyüncü,24,Premier League,2018/2019,Defender,Leicester City,371,191,180,Turkey,6,4,2,0,0,0,0,0,0
Callum Hudson-Odoi,20,Premier League,2018/2019,Midfielder,Chelsea,391,267,124,England,10,6,4,0,0,0,1,1,0
Callum Paterson,26,Premier League,2018/2019,Defender,Cardiff City,1996,1024,972,Scotland,27,14,13,4,3,1,1,0,1
Callum Roberts,23,Premier League,2018/2019,Forward,Newcastle United,0,0,0,England,0,0,0,0,0,0,0,0,0
Callum Slattery,22,Premier League,2018/2019,Midfielder,Southampton,110,6,104,England,3,1,2,0,0,0,0,0,0
Callum Wilson,29,Premier League,2018/2019,Forward,AFC Bournemouth,2535,1324,1211,England,30,15,15,14,5,9,9,4,5
Calum Chambers,26,Premier League,2018/2019,Defender,Fulham,2587,1458,1129,England,31,17,14,2,2,0,0,0,0
Cameron John,21,Premier League,2018/2019,Defender,Wolverhampton Wanderers,0,0,0,England,0,0,0,0,0,0,0,0,0
Carl Jenkinson,29,Premier League,2018/2019,Defender,Arsenal,166,166,0,England,3,3,0,0,0,0,0,0,0
Carlos Sánchez,35,Premier League,2018/2019,Midfielder,West Ham United,240,120,120,Colombia,7,4,3,0,0,0,0,0,0
Cedric Soares,29,Premier League,2018/2019,Defender,Southampton,1494,651,843,Portugal,18,8,10,1,1,0,2,0,2
Cenk Tosun,29,Premier League,2018/2019,Forward,Everton,1050,536,514,Turkey,25,13,12,3,2,1,3,1,2
Cesar Azpilicueta,31,Premier League,2018/2019,Defender,Chelsea,3403,1693,1710,Spain,38,19,19,1,0,1,5,3,2
Cesc Fabregas,33,Premier League,2018/2019,Midfielder,Chelsea,175,73,102,Spain,6,4,2,0,0,0,0,0,0
Charlie Austin,31,Premier League,2018/2019,Forward,Southampton,980,454,526,England,25,13,12,2,1,1,2,1,1
Charlie Daniels,34,Premier League,2018/2019,Defender,AFC Bournemouth,1583,803,780,England,21,11,10,1,1,0,0,0,0
Charlie Taylor,27,Premier League,2018/2019,Defender,Burnley,3240,1636,1604,England,38,19,19,0,0,0,1,1,0
Cheikhou Kouyaté,31,Premier League,2018/2019,Midfielder,Crystal Palace,1897,865,1032,Senegal,31,14,17,0,0,0,2,1,1
Chris Löwe,31,Premier League,2018/2019,Defender,Huddersfield Town,2056,932,1124,Germany,29,15,14,0,0,0,2,1,1
Chris Mepham,23,Premier League,2018/2019,Defender,AFC Bournemouth,849,436,413,Wales,13,6,7,0,0,0,1,0,1
Chris Smalling,31,Premier League,2018/2019,Defender,Manchester United,2128,1138,990,England,24,13,11,1,0,1,0,0,0
Chris Wood,29,Premier League,2018/2019,Forward,Burnley,2582,1330,1252,New Zealand,38,19,19,10,4,6,2,0,2
Christian Atsu Twasam,29,Premier League,2018/2019,Midfielder,Newcastle United,1487,710,777,Ghana,28,13,15,1,1,0,0,0,0
Christian Benteke,30,Premier League,2018/2019,Forward,Crystal Palace,813,526,287,Belgium,16,10,6,1,0,1,1,0,1
Christian Eriksen,29,Premier League,2018/2019,Midfielder,Tottenham Hotspur,2772,1457,1315,Denmark,35,18,17,8,6,2,12,8,4
Christian Fuchs,34,Premier League,2018/2019,Defender,Leicester City,206,90,116,Austria,3,1,2,0,0,0,0,0,0
Christian Kabasele,30,Premier League,2018/2019,Defender,Watford,1587,957,630,Belgium,21,14,7,0,0,0,0,0,0
Christopher Schindler,30,Premier League,2018/2019,Defender,Huddersfield Town,3262,1642,1620,Germany,37,19,18,1,0,1,0,0,0
Ciaran Clark,31,Premier League,2018/2019,Defender,Newcastle United,857,416,441,Republic of Ireland,11,6,5,3,1,2,0,0,0
Claudio Andrés Bravo Muñoz,37,Premier League,2018/2019,Goalkeeper,Manchester City,0,0,0,Chile,0,0,0,0,0,0,0,0,0
Collin Quaner,29,Premier League,2018/2019,Forward,Huddersfield Town,37,9,28,Germany,2,1,1,0,0,0,0,0,0
Connor Wickham,28,Premier League,2018/2019,Forward,Crystal Palace,61,49,12,England,6,3,3,0,0,0,1,0,1
Conor Coady,28,Premier League,2018/2019,Midfielder,Wolverhampton Wanderers,3420,1710,1710,England,38,19,19,0,0,0,0,0,0
Conor Coventry,21,Premier League,2018/2019,Midfielder,West Ham United,0,0,0,Republic of Ireland,0,0,0,0,0,0,0,0,0
Craig Cathcart,32,Premier League,2018/2019,Defender,Watford,3099,1561,1538,Northern Ireland,36,18,18,3,1,2,0,0,0
Curtis Jones,20,Premier League,2018/2019,Midfielder,Liverpool,0,0,0,England,0,0,0,0,0,0,0,0,0
Cyrus Christie,28,Premier League,2018/2019,Defender,Fulham,1943,1053,890,Republic of Ireland,28,15,13,0,0,0,1,1,0
Dale Stephens,31,Premier League,2018/2019,Midfielder,Brighton & Hove Albion,2487,1191,1296,England,30,14,16,1,0,1,1,0,1
Damián Emiliano Martínez,28,Premier League,2018/2019,Goalkeeper,Arsenal,0,0,0,Argentina,0,0,0,0,0,0,0,0,0
Dan Burn,28,Premier League,2018/2019,Defender,Brighton & Hove Albion,0,0,0,England,0,0,0,0,0,0,0,0,0
Dan Gosling,31,Premier League,2018/2019,Midfielder,AFC Bournemouth,1737,911,826,England,25,13,12,2,0,2,1,0,1
Daniel Amartey,26,Premier League,2018/2019,Midfielder,Leicester City,640,307,333,Ghana,9,5,4,0,0,0,0,0,0
Daniel Sturridge,31,Premier League,2018/2019,Forward,Liverpool,496,152,344,England,18,9,9,2,1,1,1,1,0
Daniel William John Ings,28,Premier League,2018/2019,Forward,Southampton,1668,922,746,England,24,13,11,7,3,4,3,3,0
Daniel Williams,32,Premier League,2018/2019,Midfielder,Huddersfield Town,93,13,80,USA,5,1,4,0,0,0,0,0,0
Danilo,29,Premier League,2018/2019,Defender,Manchester City,806,450,356,Brazil,11,5,6,1,0,1,0,0,0
Danny Drinkwater,31,Premier League,2018/2019,Midfielder,Chelsea,0,0,0,England,0,0,0,0,0,0,0,0,0
Danny Rose,30,Premier League,2018/2019,Defender,Tottenham Hotspur,1806,969,837,England,26,13,13,0,0,0,3,1,2
Danny Simpson,34,Premier League,2018/2019,Defender,Leicester City,291,26,265,England,6,2,4,0,0,0,0,0,0
Danny Ward,27,Premier League,2018/2019,Goalkeeper,Leicester City,0,0,0,Wales,0,0,0,0,0,0,0,0,0
Danny Ward,30,Premier League,2018/2019,Forward,Cardiff City,440,246,194,England,14,6,8,1,1,0,0,0,0
Danny Welbeck,30,Premier League,2018/2019,Forward,Arsenal,147,47,100,England,8,4,4,1,1,0,1,0,1
Daryl Janmaat,31,Premier League,2018/2019,Defender,Watford,1521,836,685,Netherlands,18,10,8,0,0,0,2,2,0
David Brooks,23,Premier League,2018/2019,Forward,AFC Bournemouth,2278,1289,989,England,30,17,13,7,4,3,5,3,2
David Button,32,Premier League,2018/2019,Goalkeeper,Brighton & Hove Albion,360,180,180,England,4,2,2,0,0,0,0,0,0
David de Gea,30,Premier League,2018/2019,Goalkeeper,Manchester United,3420,1710,1710,Spain,38,19,19,0,0,0,0,0,0
David Junior Hoilett,30,Premier League,2018/2019,Forward,Cardiff City,2142,1008,1134,Canada,32,17,15,3,2,1,1,0,1
David Luiz,33,Premier League,2018/2019,Defender,Chelsea,3239,1709,1530,Brazil,36,19,17,3,3,0,2,1,1
David Silva,35,Premier League,2018/2019,Midfielder,Manchester City,2411,1088,1323,Spain,33,16,17,6,4,2,8,3,5
Davide Zappacosta,28,Premier League,2018/2019,Defender,Chelsea,125,35,90,Italy,4,3,1,0,0,0,0,0,0
Davinson Sánchez Mina,24,Premier League,2018/2019,Defender,Tottenham Hotspur,1943,873,1070,Colombia,23,10,13,1,1,0,1,0,1
Davy Pröpper,29,Premier League,2018/2019,Midfielder,Brighton & Hove Albion,2551,1371,1180,Netherlands,30,16,14,1,0,1,1,0,1
DeAndre Yedlin,27,Premier League,2018/2019,Defender,Newcastle United,2475,1313,1162,USA,29,16,13,1,0,1,2,1,1
Declan Rice,22,Premier League,2018/2019,Midfielder,West Ham United,3005,1440,1565,Republic of Ireland,34,16,18,2,2,0,0,0,0
Dejan Lovren,31,Premier League,2018/2019,Defender,Liverpool,985,540,445,Croatia,13,7,6,1,1,0,0,0,0
Dele Alli,24,Premier League,2018/2019,Midfielder,Tottenham Hotspur,1827,755,1072,England,25,11,14,5,1,4,3,2,1
Demarai Gray,24,Premier League,2018/2019,Midfielder,Leicester City,1992,1069,923,England,34,17,17,4,1,3,1,1,0
Demeaco Duhaney,22,Premier League,2018/2019,Defender,Huddersfield Town,46,46,0,England,1,1,0,0,0,0,0,0,0
Denis Odoi,32,Premier League,2018/2019,Defender,Fulham,2593,1153,1440,Belgium,31,15,16,0,0,0,1,0,1
Denis Suárez,27,Premier League,2018/2019,Midfielder,Arsenal,67,29,38,Spain,4,2,2,0,0,0,0,0,0
Diego Rico,28,Premier League,2018/2019,Defender,AFC Bournemouth,607,148,459,Spain,12,4,8,0,0,0,0,0,0
Diogo José Teixeira da Silva,24,Premier League,2018/2019,Midfielder,Wolverhampton Wanderers,2371,1210,1161,Portugal,33,16,17,9,7,2,5,3,2
Divock Origi,25,Premier League,2018/2019,Forward,Liverpool,366,176,190,Belgium,12,5,7,3,2,1,1,0,1
Domingos Quina,21,Premier League,2018/2019,Midfielder,Watford,335,217,118,Portugal,8,5,3,1,1,0,0,0,0
Dominic Calvert-Lewin,24,Premier League,2018/2019,Forward,Everton,1774,1023,751,England,35,18,17,6,3,3,2,2,0
Dominic Solanke,23,Premier League,2018/2019,Forward,AFC Bournemouth,341,165,176,England,10,4,6,0,0,0,1,1,0
Dwight McNeil,21,Premier League,2018/2019,Forward,Burnley,1599,941,658,England,21,12,9,3,3,0,5,3,2
Eden Hazard,30,Premier League,2018/2019,Midfielder,Chelsea,2926,1527,1399,Belgium,37,19,18,16,11,5,15,10,5
Ederson,27,Premier League,2018/2019,Goalkeeper,Manchester City,3420,1710,1710,Brazil,38,19,19,0,0,0,1,1,0
Edward Nketiah,21,Premier League,2018/2019,Forward,Arsenal,62,4,58,England,5,1,4,1,0,1,0,0,0
Elias Kachunga,28,Premier League,2018/2019,Forward,Huddersfield Town,1181,611,570,Congo DR,20,9,11,0,0,0,0,0,0
Emerson Hyndman,25,Premier League,2018/2019,Midfielder,AFC Bournemouth,37,0,37,USA,1,0,1,0,0,0,0,0,0
Emerson Palmieri dos Santos,26,Premier League,2018/2019,Defender,Chelsea,660,360,300,Italy,10,4,6,0,0,0,0,0,0
Emile Smith Rowe,20,Premier League,2018/2019,Midfielder,Arsenal,0,0,0,England,0,0,0,0,0,0,0,0,0
Eric Bertrand Bailly,26,Premier League,2018/2019,Defender,Manchester United,637,349,288,Côte d'Ivoire,12,5,7,0,0,0,0,0,0
Eric Dier,27,Premier League,2018/2019,Midfielder,Tottenham Hotspur,1510,674,836,England,20,9,11,3,2,1,0,0,0
Erik Durm,28,Premier League,2018/2019,Defender,Huddersfield Town,2052,869,1183,Germany,28,13,15,0,0,0,1,0,1
Erik Lamela,29,Premier League,2018/2019,Midfielder,Tottenham Hotspur,971,493,478,Argentina,19,11,8,4,1,3,2,1,1
Ethan Ampadu,20,Premier League,2018/2019,Midfielder,Chelsea,0,0,0,Wales,0,0,0,0,0,0,0,0,0
Etienne Capoue,32,Premier League,2018/2019,Midfielder,Watford,2947,1518,1429,France,33,17,16,1,0,1,3,2,1
Fabián Cornelio Balbuena González,29,Premier League,2018/2019,Defender,West Ham United,2014,934,1080,Paraguay,23,11,12,1,0,1,0,0,0
Fabian Delph,31,Premier League,2018/2019,Midfielder,Manchester City,725,266,459,England,11,5,6,0,0,0,1,1,0
Fabian Schär,29,Premier League,2018/2019,Defender,Newcastle United,2002,1173,829,Switzerland,24,14,10,4,3,1,1,0,1
Fabinho,27,Premier League,2018/2019,Midfielder,Liverpool,2013,1051,962,Brazil,28,14,14,1,1,0,2,1,1
Fabricio Martín Agosto Ramírez,33,Premier League,2018/2019,Goalkeeper,Fulham,180,90,90,Spain,2,1,1,0,0,0,0,0,0
Faustino Marcos Alberto Rojo,31,Premier League,2018/2019,Defender,Manchester United,211,211,0,Argentina,5,5,0,0,0,0,0,0,0
Federico Fernández,32,Premier League,2018/2019,Defender,Newcastle United,1484,607,877,Argentina,19,8,11,0,0,0,1,1,0
Felipe Anderson Pereira Gomes,27,Premier League,2018/2019,Midfielder,West Ham United,3054,1439,1615,Brazil,36,17,19,9,4,5,4,2,2
Fernando Llorente Torres,36,Premier League,2018/2019,Forward,Tottenham Hotspur,683,508,175,Spain,20,11,9,1,1,0,4,4,0
Fernando Luiz Rosa,35,Premier League,2018/2019,Midfielder,Manchester City,2381,1286,1095,Brazil,29,15,14,1,1,0,3,3,0
Florent Hadergjonaj,26,Premier League,2018/2019,Defender,Huddersfield Town,1840,1011,829,Switzerland,24,12,12,0,0,0,0,0,0
Florian Lejeune,29,Premier League,2018/2019,Defender,Newcastle United,1055,515,540,France,12,6,6,0,0,0,0,0,0
Florin Andone,27,Premier League,2018/2019,Forward,Brighton & Hove Albion,874,416,458,Romania,23,12,11,3,2,1,0,0,0
Floyd Ayité,32,Premier League,2018/2019,Midfielder,Fulham,465,296,169,Togo,16,7,9,1,0,1,0,0,0
Fousseni Diabaté,25,Premier League,2018/2019,Midfielder,Leicester City,55,0,55,Mali,1,0,1,0,0,0,0,0,0
Francisco Femenía Far,30,Premier League,2018/2019,Midfielder,Watford,2045,1011,1034,Spain,29,14,15,1,1,0,1,1,0
Fraser Forster,33,Premier League,2018/2019,Goalkeeper,Southampton,90,0,90,England,1,0,1,0,0,0,0,0,0
Freddie Woodman,24,Premier League,2018/2019,Goalkeeper,Newcastle United,0,0,0,England,0,0,0,0,0,0,0,0,0
Frederico Rodrigues Santos,28,Premier League,2018/2019,Midfielder,Manchester United,1045,577,468,Brazil,17,9,8,1,1,0,1,0,1
Gabriel Jesus,24,Premier League,2018/2019,Forward,Manchester City,1019,702,317,Brazil,29,14,15,7,5,2,3,1,2
Gaëtan Bong Songo,32,Premier League,2018/2019,Defender,Brighton & Hove Albion,1805,720,1085,Cameroon,22,8,14,0,0,0,0,0,0
Gary Cahill,35,Premier League,2018/2019,Defender,Chelsea,22,1,21,England,2,1,1,0,0,0,0,0,0
Gary Madine,30,Premier League,2018/2019,Forward,Cardiff City,32,17,15,England,5,3,2,0,0,0,0,0,0
George Marsh,22,Premier League,2018/2019,Midfielder,Tottenham Hotspur,0,0,0,England,0,0,0,0,0,0,0,0,0
Georges-Kevin N'Koudou Mbida,26,Premier League,2018/2019,Forward,Tottenham Hotspur,4,0,4,France,1,0,1,0,0,0,1,0,1
Georginio Wijnaldum,30,Premier League,2018/2019,Midfielder,Liverpool,2735,1413,1322,Netherlands,35,18,17,3,1,2,0,0,0
Gerard Deulofeu,27,Premier League,2018/2019,Forward,Watford,2082,949,1133,Spain,30,14,16,10,3,7,5,3,2
Glenn Murray,37,Premier League,2018/2019,Forward,Brighton & Hove Albion,2513,1383,1130,England,38,19,19,13,8,5,1,1,0
Gonzalo Higuain,33,Premier League,2018/2019,Forward,Chelsea,1092,496,596,Argentina,14,6,8,5,4,1,0,0,0
Grady Diangana,22,Premier League,2018/2019,Midfielder,West Ham United,604,326,278,England,17,9,8,0,0,0,1,1,0
Granit Xhaka,28,Premier League,2018/2019,Midfielder,Arsenal,2502,1317,1185,Switzerland,29,15,14,4,2,2,2,0,2
Greg Cunningham,30,Premier League,2018/2019,Defender,Cardiff City,630,450,180,Republic of Ireland,7,5,2,0,0,0,0,0,0
Gylfi Sigurdsson,31,Premier League,2018/2019,Midfielder,Everton,3134,1602,1532,Iceland,38,19,19,13,7,6,6,2,4
Hamza Choudhury,23,Premier League,2018/2019,Midfielder,Leicester City,596,308,288,England,9,4,5,0,0,0,0,0,0
Harry Arter,31,Premier League,2018/2019,Midfielder,Cardiff City,2008,1186,822,Republic of Ireland,25,14,11,0,0,0,1,1,0
Harry Kane,27,Premier League,2018/2019,Forward,Tottenham Hotspur,2427,1066,1361,England,28,12,16,17,6,11,4,2,2
Harry Maguire,28,Premier League,2018/2019,Defender,Leicester City,2599,1350,1249,England,31,15,16,3,0,3,0,0,0
Harry Winks,25,Premier League,2018/2019,Midfielder,Tottenham Hotspur,1591,832,759,England,26,13,13,1,0,1,0,0,0
Harvey Elliot,0,Premier League,2018/2019,Forward,Fulham,18,16,2,England,2,1,1,0,0,0,0,0,0
Harvey Lewis Barnes,23,Premier League,2018/2019,Midfielder,Leicester City,1007,601,406,England,16,9,7,1,0,1,2,2,0
Håvard Nordtveit,30,Premier League,2018/2019,Midfielder,Fulham,361,90,271,Norway,5,1,4,0,0,0,1,0,1
Hector Bellerin,26,Premier League,2018/2019,Defender,Arsenal,1535,882,653,Spain,19,10,9,0,0,0,5,4,1
Hélder Wander Sousa Azevedo Costa,27,Premier League,2018/2019,Midfielder,Wolverhampton Wanderers,1345,657,688,Portugal,25,11,14,1,0,1,2,1,1
Henrikh Mkhitaryan,32,Premier League,2018/2019,Midfielder,Arsenal,1643,650,993,Armenia,25,11,14,6,3,3,4,3,1
Heung-Min Son,28,Premier League,2018/2019,Forward,Tottenham Hotspur,2048,1161,887,South Korea,31,16,15,12,8,4,6,2,4
Heurelho da Silva Gomes,40,Premier League,2018/2019,Goalkeeper,Watford,0,0,0,Brazil,0,0,0,0,0,0,0,0,0
Hugo Lloris,34,Premier League,2018/2019,Goalkeeper,Tottenham Hotspur,2970,1620,1350,France,33,18,15,0,0,0,0,0,0
Ibrahima Cissé,27,Premier League,2018/2019,Midfielder,Fulham,87,9,78,Belgium,3,1,2,0,0,0,0,0,0
Idrissa Gana Gueye,31,Premier League,2018/2019,Midfielder,Everton,2825,1407,1418,Senegal,33,16,17,0,0,0,2,1,1
İlkay Gündoğan,30,Premier League,2018/2019,Midfielder,Manchester City,2135,985,1150,Germany,31,15,16,6,4,2,3,0,3
Isaac Ajayi Success,25,Premier League,2018/2019,Forward,Watford,1037,461,576,Nigeria,30,15,15,1,1,0,1,0,1
Isaac Hayden,26,Premier League,2018/2019,Midfielder,Newcastle United,1886,904,982,England,25,11,14,1,0,1,4,4,0
Isaac Mbenza,25,Premier League,2018/2019,Forward,Huddersfield Town,981,589,392,Belgium,22,13,9,1,1,0,1,1,0
Issa Diop,24,Premier League,2018/2019,Defender,West Ham United,2970,1530,1440,France,33,17,16,1,1,0,0,0,0
Ivan Ricardo Neves Abreu Cavaleiro,27,Premier League,2018/2019,Forward,Wolverhampton Wanderers,683,331,352,Portugal,23,13,10,3,2,1,1,0,1
Jack Cork,31,Premier League,2018/2019,Midfielder,Burnley,3313,1693,1620,England,37,19,18,1,1,0,2,1,1
Jack Simpson,24,Premier League,2018/2019,Defender,AFC Bournemouth,403,240,163,England,6,3,3,0,0,0,0,0,0
Jack Stephens,27,Premier League,2018/2019,Defender,Southampton,1697,816,881,England,24,10,14,1,1,0,0,0,0
Jack Wilshere,29,Premier League,2018/2019,Midfielder,West Ham United,389,181,208,England,8,4,4,0,0,0,1,0,1
Jacob Murphy,26,Premier League,2018/2019,Midfielder,Newcastle United,300,167,133,England,9,3,6,0,0,0,1,0,1
Jaïro Riedewald,24,Premier League,2018/2019,Defender,Crystal Palace,0,0,0,Netherlands,0,0,0,0,0,0,0,0,0
Jamal Lascelles,27,Premier League,2018/2019,Defender,Newcastle United,2748,1308,1440,England,32,16,16,0,0,0,1,1,0
James Garner,20,Premier League,2018/2019,Defender,Manchester United,0,0,0,England,1,0,1,0,0,0,0,0,0
James Maddison,24,Premier League,2018/2019,Midfielder,Leicester City,2850,1535,1315,England,36,18,18,7,3,4,7,4,3
James McArthur,33,Premier League,2018/2019,Midfielder,Crystal Palace,3071,1506,1565,Scotland,38,19,19,3,1,2,6,1,5
James McCarthy,30,Premier League,2018/2019,Midfielder,Everton,14,14,0,Republic of Ireland,1,1,0,0,0,0,0,0,0
James Milner,35,Premier League,2018/2019,Midfielder,Liverpool,1785,646,1139,England,31,12,19,5,0,5,4,2,2
James Tarkowski,28,Premier League,2018/2019,Defender,Burnley,3087,1620,1467,England,35,18,17,3,2,1,1,1,0
James Tomkins,32,Premier League,2018/2019,Defender,Crystal Palace,2563,1140,1423,England,29,13,16,1,0,1,1,0,1
James Ward-Prowse,26,Premier League,2018/2019,Midfielder,Southampton,1942,942,1000,England,26,13,13,7,5,2,0,0,0
Jamie Sterry,25,Premier League,2018/2019,Defender,Newcastle United,0,0,0,England,0,0,0,0,0,0,0,0,0
Jamie Vardy,34,Premier League,2018/2019,Forward,Leicester City,2735,1418,1317,England,34,17,17,18,8,10,4,3,1
Jan Bednarek,24,Premier League,2018/2019,Defender,Southampton,2151,1126,1025,Poland,25,13,12,0,0,0,1,0,1
Jan Vertonghen,33,Premier League,2018/2019,Defender,Tottenham Hotspur,1915,884,1031,Belgium,22,10,12,1,0,1,0,0,0
Jannik Vestergaard,28,Premier League,2018/2019,Defender,Southampton,2030,1130,900,Denmark,23,13,10,0,0,0,0,0,0
Jason Puncheon,34,Premier League,2018/2019,Midfielder,Huddersfield Town,391,248,143,England,11,6,5,0,0,0,0,0,0
Jason Steele,30,Premier League,2018/2019,Goalkeeper,Brighton & Hove Albion,0,0,0,England,0,0,0,0,0,0,0,0,0
Javier Hernandez,32,Premier League,2018/2019,Forward,West Ham United,1335,694,641,Mexico,25,13,12,7,5,2,1,0,1
Javier Manquillo Gaitán,26,Premier League,2018/2019,Defender,Newcastle United,1097,503,594,Spain,18,9,9,0,0,0,3,2,1
Jayson Molumby,21,Premier League,2018/2019,Midfielder,Brighton & Hove Albion,0,0,0,Republic of Ireland,0,0,0,0,0,0,0,0,0
Jazz Richards,29,Premier League,2018/2019,Defender,Cardiff City,128,52,76,Wales,4,2,2,0,0,0,0,0,0
Jean Michaël Seri,29,Premier League,2018/2019,Midfielder,Fulham,2252,1112,1140,Côte d'Ivoire,32,15,17,1,1,0,2,0,2
Jeff Hendrick,29,Premier League,2018/2019,Midfielder,Burnley,2069,898,1171,Republic of Ireland,32,15,17,3,1,2,0,0,0
Jefferson Lerma,26,Premier League,2018/2019,Midfielder,AFC Bournemouth,2511,1319,1192,Colombia,30,15,15,2,0,2,0,0,0
Jeffrey Schlupp,28,Premier League,2018/2019,Defender,Crystal Palace,1665,849,816,Ghana,30,14,16,4,1,3,1,1,0
Jermain Defoe,38,Premier League,2018/2019,Forward,AFC Bournemouth,21,0,21,England,4,1,3,0,0,0,0,0,0
Jesse Lingard,28,Premier League,2018/2019,Midfielder,Manchester United,1668,963,705,England,27,15,12,4,1,3,2,1,1
João Moutinho,34,Premier League,2018/2019,Midfielder,Wolverhampton Wanderers,3040,1532,1508,Portugal,38,19,19,1,0,1,8,5,3
Joe Bennett,31,Premier League,2018/2019,Defender,Cardiff City,2641,1142,1499,England,30,13,17,0,0,0,1,1,0
Joe Bryan,27,Premier League,2018/2019,Defender,Fulham,2350,1214,1136,England,28,15,13,0,0,0,1,1,0
Joe Daniel Tupper,23,Premier League,2018/2019,Goalkeeper,Crystal Palace,0,0,0,England,0,0,0,0,0,0,0,0,0
Joe Gomez,23,Premier League,2018/2019,Defender,Liverpool,1060,493,567,England,16,8,8,0,0,0,0,0,0
Joe Hart,33,Premier League,2018/2019,Goalkeeper,Burnley,1710,810,900,England,19,9,10,0,0,0,0,0,0
Joe Powell,22,Premier League,2018/2019,Forward,West Ham United,0,0,0,England,0,0,0,0,0,0,0,0,0
Joe Ralls,27,Premier League,2018/2019,Midfielder,Cardiff City,1959,847,1112,England,28,15,13,0,0,0,0,0,0
Joel Coleman,25,Premier League,2018/2019,Goalkeeper,Huddersfield Town,90,0,90,England,1,0,1,0,0,0,0,0,0
Joel Matip,29,Premier League,2018/2019,Defender,Liverpool,1532,811,721,Cameroon,22,10,12,1,1,0,0,0,0
Joel Ward,31,Premier League,2018/2019,Defender,Crystal Palace,551,191,360,England,7,3,4,1,1,0,0,0,0
Johann Berg Guðmunds­son,30,Premier League,2018/2019,Midfielder,Burnley,1748,847,901,Iceland,29,15,14,3,0,3,6,5,1
John Ruddy,34,Premier League,2018/2019,Goalkeeper,Wolverhampton Wanderers,90,90,0,England,1,1,0,0,0,0,0,0,0
John Stones,26,Premier League,2018/2019,Defender,Manchester City,1762,968,794,England,24,12,12,0,0,0,0,0,0
Jon Gorenc Stankovič,25,Premier League,2018/2019,Defender,Huddersfield Town,718,218,500,Slovenia,11,3,8,1,0,1,0,0,0
Jonas Lössl,32,Premier League,2018/2019,Goalkeeper,Huddersfield Town,2777,1427,1350,Denmark,31,16,15,0,0,0,1,1,0
Jonathan Hogg,32,Premier League,2018/2019,Midfielder,Huddersfield Town,2377,1294,1083,England,29,16,13,0,0,0,1,1,0
Jonathan Walters,37,Premier League,2018/2019,Forward,Burnley,0,0,0,Republic of Ireland,0,0,0,0,0,0,0,0,0
Jonjo Shelvey,29,Premier League,2018/2019,Midfielder,Newcastle United,944,403,541,England,16,8,8,1,0,1,1,0,1
Jonjoe Kenny,24,Premier League,2018/2019,Defender,Everton,790,413,377,England,10,5,5,0,0,0,1,1,0
Jonny,27,Premier League,2018/2019,Defender,Wolverhampton Wanderers,2780,1269,1511,Spain,33,16,17,1,1,0,1,1,0
Jonny Evans,33,Premier League,2018/2019,Defender,Leicester City,1995,1074,921,Northern Ireland,24,12,12,1,1,0,0,0,0
Jordan Ayew,29,Premier League,2018/2019,Forward,Crystal Palace,1186,616,570,Ghana,20,8,12,1,0,1,2,0,2
Jordan Henderson,30,Premier League,2018/2019,Midfielder,Liverpool,1983,925,1058,England,32,16,16,1,0,1,3,2,1
Jordan Pickford,27,Premier League,2018/2019,Goalkeeper,Everton,3420,1710,1710,England,38,19,19,0,0,0,0,0,0
Jordon Ibe,25,Premier League,2018/2019,Midfielder,AFC Bournemouth,795,334,461,England,19,10,9,1,0,1,1,1,0
Jorginho,29,Premier League,2018/2019,Midfielder,Chelsea,3165,1621,1544,Italy,37,19,18,2,0,2,0,0,0
José Diogo Dalot Teixeira,22,Premier League,2018/2019,Defender,Manchester United,1015,525,490,Portugal,16,7,9,0,0,0,2,2,0
José Holebas,36,Premier League,2018/2019,Defender,Watford,2394,1224,1170,Greece,28,15,13,3,2,1,6,5,1
Jose Izquierdo,28,Premier League,2018/2019,Forward,Brighton & Hove Albion,794,365,429,Colombia,15,8,7,0,0,0,1,0,1
José Luis Sanmartín Mato,31,Premier League,2018/2019,Forward,Newcastle United,586,308,278,Spain,16,9,7,2,2,0,0,0,0
Joseph Willock,21,Premier League,2018/2019,Midfielder,Arsenal,64,0,64,England,2,0,2,0,0,0,0,0,0
Josh Benson,21,Premier League,2018/2019,Midfielder,Burnley,0,0,0,England,0,0,0,0,0,0,0,0,0
Josh Knight,23,Premier League,2018/2019,Defender,Leicester City,0,0,0,England,0,0,0,0,0,0,0,0,0
Josh Murphy,26,Premier League,2018/2019,Forward,Cardiff City,1825,1123,702,England,29,17,12,3,2,1,2,1,1
Joshua King,29,Premier League,2018/2019,Forward,AFC Bournemouth,2974,1563,1411,Norway,35,18,17,12,9,3,3,3,0
Joshua Sims,24,Premier League,2018/2019,Midfielder,Southampton,209,139,70,England,7,4,3,0,0,0,1,1,0
Juan Marcos Foyth,23,Premier League,2018/2019,Defender,Tottenham Hotspur,930,450,480,Argentina,12,6,6,1,0,1,0,0,0
Juan Mata,32,Premier League,2018/2019,Midfielder,Manchester United,1294,833,461,Spain,22,13,9,3,3,0,2,2,0
Julián Speroni,41,Premier League,2018/2019,Goalkeeper,Crystal Palace,90,0,90,Argentina,1,0,1,0,0,0,0,0,0
Juninho Bacuna,23,Premier League,2018/2019,Midfielder,Huddersfield Town,1414,722,692,Netherlands,21,11,10,1,0,1,0,0,0
Junior Stanislas,31,Premier League,2018/2019,Midfielder,AFC Bournemouth,1027,559,468,England,23,12,11,2,1,1,3,3,0
Jürgen Locadia,27,Premier League,2018/2019,Forward,Brighton & Hove Albion,1227,590,637,Netherlands,26,14,12,2,2,0,0,0,0
Kadeem Harris,27,Premier League,2018/2019,Midfielder,Cardiff City,366,133,233,England,13,5,8,1,1,0,0,0,0
Karl Darlow,30,Premier League,2018/2019,Goalkeeper,Newcastle United,0,0,0,England,0,0,0,0,0,0,0,0,0
Karlan Ahearne-Grant,23,Premier League,2018/2019,Forward,Huddersfield Town,874,331,543,England,13,6,7,4,2,2,0,0,0
Kasper Schmeichel,34,Premier League,2018/2019,Goalkeeper,Leicester City,3420,1710,1710,Denmark,38,19,19,0,0,0,0,0,0
Kayne Ramsey,20,Premier League,2018/2019,Midfielder,Southampton,90,90,0,England,1,1,0,0,0,0,0,0,0
Kazaiah Sterling,22,Premier League,2018/2019,Forward,Tottenham Hotspur,0,0,0,England,0,0,0,0,0,0,0,0,0
Kelechi Iheanacho,24,Premier League,2018/2019,Forward,Leicester City,926,408,518,Nigeria,30,14,16,1,1,0,3,2,1
Kelland Watts,21,Premier League,2018/2019,Midfielder,Newcastle United,0,0,0,England,0,0,0,0,0,0,0,0,0
Ken Sema,27,Premier League,2018/2019,Midfielder,Watford,755,301,454,Sweden,17,8,9,1,0,1,2,1,1
Kenneth Dahrup Zohorè,27,Premier League,2018/2019,Forward,Cardiff City,746,388,358,Denmark,19,11,8,1,0,1,1,0,1
Kepa Arrizabalaga,26,Premier League,2018/2019,Goalkeeper,Chelsea,3240,1620,1620,Spain,36,18,18,0,0,0,0,0,0
Kevin De Bruyne,29,Premier League,2018/2019,Midfielder,Manchester City,974,477,497,Belgium,19,9,10,2,2,0,2,0,2
Kevin Long,30,Premier League,2018/2019,Defender,Burnley,513,90,423,Republic of Ireland,6,1,5,0,0,0,1,0,1
Kevin McDonald,32,Premier League,2018/2019,Midfielder,Fulham,842,399,443,Scotland,15,8,7,0,0,0,0,0,0
Kieran Dowell,23,Premier League,2018/2019,Midfielder,Everton,0,0,0,England,0,0,0,0,0,0,0,0,0
Kieran Trippier,30,Premier League,2018/2019,Defender,Tottenham Hotspur,2278,1188,1090,England,27,14,13,1,1,0,3,0,3
Konstantinos Mavropanos,23,Premier League,2018/2019,Defender,Arsenal,150,46,104,Greece,4,1,3,0,0,0,0,0,0
Kortney Hause,25,Premier League,2018/2019,Defender,Wolverhampton Wanderers,0,0,0,England,0,0,0,0,0,0,0,0,0
Kurt Zouma,26,Premier League,2018/2019,Defender,Everton,2610,1350,1260,France,32,16,16,2,1,1,2,0,2
Kyle Taylor,21,Premier League,2018/2019,Midfielder,AFC Bournemouth,0,0,0,England,0,0,0,0,0,0,0,0,0
Kyle Walker,30,Premier League,2018/2019,Defender,Manchester City,2777,1245,1532,England,33,15,18,1,1,0,1,0,1
Kyle Walker-Peters,23,Premier League,2018/2019,Defender,Tottenham Hotspur,374,272,102,England,6,4,2,0,0,0,3,3,0
Laurent Depoitre,32,Premier League,2018/2019,Forward,Huddersfield Town,1059,446,613,Belgium,23,12,11,0,0,0,1,0,1
Laurent Koscielny,35,Premier League,2018/2019,Defender,Arsenal,1328,484,844,France,17,6,11,3,2,1,0,0,0
Lazar Marković,27,Premier League,2018/2019,Midfielder,Fulham,44,0,44,Serbia,1,0,1,0,0,0,0,0,0
Leander Dendoncker,25,Premier League,2018/2019,Midfielder,Wolverhampton Wanderers,1469,635,834,Belgium,19,9,10,2,1,1,0,0,0
Leandro Bacuna,29,Premier League,2018/2019,Midfielder,Cardiff City,554,302,252,Curaçao,11,6,5,0,0,0,0,0,0
Lee Grant,38,Premier League,2018/2019,Goalkeeper,Manchester United,0,0,0,England,0,0,0,0,0,0,0,0,0
Lee Peltier,34,Premier League,2018/2019,Defender,Cardiff City,1542,521,1021,England,20,7,13,0,0,0,0,0,0
Leighton Baines,36,Premier League,2018/2019,Defender,Everton,376,141,235,England,6,3,3,0,0,0,0,0,0
Leon Balogun,32,Premier League,2018/2019,Defender,Brighton & Hove Albion,591,309,282,Nigeria,8,4,4,1,1,0,0,0,0
Leonardo Bonatini Lohner Maia,27,Premier League,2018/2019,Forward,Wolverhampton Wanderers,128,61,67,Brazil,7,4,3,0,0,0,1,0,1
Leroy Sané,25,Premier League,2018/2019,Midfielder,Manchester City,1867,1024,843,Germany,31,16,15,10,5,5,10,6,4
Lewis Cass,21,Premier League,2018/2019,Defender,Newcastle United,0,0,0,England,0,0,0,0,0,0,0,0,0
Lewis Cook,24,Premier League,2018/2019,Midfielder,AFC Bournemouth,721,381,340,England,13,7,6,0,0,0,0,0,0
Lewis Dunk,29,Premier League,2018/2019,Defender,Brighton & Hove Albion,3153,1550,1603,England,36,18,18,2,0,2,1,0,1
Loïc Damour,30,Premier League,2018/2019,Midfielder,Cardiff City,21,4,17,France,2,1,1,0,0,0,0,0,0
Loris Karius,27,Premier League,2018/2019,Goalkeeper,Liverpool,0,0,0,Germany,0,0,0,0,0,0,0,0,0
Luca de la Torre,22,Premier League,2018/2019,Midfielder,Fulham,0,0,0,USA,0,0,0,0,0,0,0,0,0
Lucas Digne,27,Premier League,2018/2019,Defender,Everton,2990,1511,1479,France,35,17,18,4,2,2,4,2,2
Lucas Perez,32,Premier League,2018/2019,Forward,West Ham United,468,287,181,Spain,15,10,5,3,3,0,0,0,0
Lucas Rodrigues Moura da Silva,28,Premier League,2018/2019,Midfielder,Tottenham Hotspur,2127,1040,1087,Brazil,32,15,17,10,6,4,0,0,0
Lucas Torreira,25,Premier League,2018/2019,Midfielder,Arsenal,2377,1231,1146,Uruguay,34,17,17,2,2,0,2,0,2
Luciano Vietto,27,Premier League,2018/2019,Forward,Fulham,983,549,434,Argentina,20,9,11,1,1,0,4,4,0
Luka Milivojević,29,Premier League,2018/2019,Midfielder,Crystal Palace,3420,1710,1710,Serbia,38,19,19,12,7,5,2,0,2
Luke Amos,24,Premier League,2018/2019,Midfielder,Tottenham Hotspur,2,0,2,England,1,0,1,0,0,0,0,0,0
Luke Dreher,22,Premier League,2018/2019,Midfielder,Crystal Palace,0,0,0,England,1,1,0,0,0,0,0,0,0
Luke Shaw,25,Premier League,2018/2019,Defender,Manchester United,2592,1170,1422,England,29,13,16,1,1,0,4,2,2
Lys Mousset,25,Premier League,2018/2019,Forward,AFC Bournemouth,345,96,249,France,24,13,11,1,0,1,0,0,0
Maarten Stekelenburg,38,Premier League,2018/2019,Goalkeeper,Everton,0,0,0,Netherlands,0,0,0,0,0,0,0,0,0
Mamadou Sakho,31,Premier League,2018/2019,Defender,Crystal Palace,2417,1170,1247,France,27,13,14,0,0,0,0,0,0
Manolo Gabbiadini,29,Premier League,2018/2019,Forward,Southampton,470,253,217,Italy,12,6,6,1,1,0,0,0,0
Manuel Lanzini,28,Premier League,2018/2019,Midfielder,West Ham United,688,367,321,Argentina,10,5,5,1,0,1,1,0,1
Marc Albrighton,31,Premier League,2018/2019,Midfielder,Leicester City,1626,797,829,England,27,14,13,2,1,1,2,1,1
Marc Guehi,20,Premier League,2018/2019,Defender,Chelsea,0,0,0,England,0,0,0,0,0,0,0,0,0
Marc Navarro Ceciliano,25,Premier League,2018/2019,Defender,Watford,84,0,84,Spain,2,0,2,0,0,0,0,0,0
Marc Pugh,34,Premier League,2018/2019,Midfielder,AFC Bournemouth,0,0,0,England,0,0,0,0,0,0,0,0,0
Marcos Alonso,30,Premier League,2018/2019,Defender,Chelsea,2761,1338,1423,Spain,31,15,16,2,1,1,4,3,1
Marcus Bettinelli,28,Premier League,2018/2019,Goalkeeper,Fulham,630,270,360,England,7,3,4,0,0,0,0,0,0
Marcus Rashford,23,Premier League,2018/2019,Forward,Manchester United,2362,1293,1069,England,33,17,16,10,4,6,6,3,3
Mario Lemina,27,Premier League,2018/2019,Midfielder,Southampton,1615,763,852,Gabon,21,9,12,1,0,1,1,0,1
Mark Noble,33,Premier League,2018/2019,Midfielder,West Ham United,2308,1147,1161,England,31,15,16,5,2,3,5,4,1
Mark Travers,21,Premier League,2018/2019,Goalkeeper,AFC Bournemouth,180,90,90,Republic of Ireland,2,1,1,0,0,0,0,0,0
Marko Arnautović,31,Premier League,2018/2019,Forward,West Ham United,2000,1083,917,Austria,28,15,13,10,7,3,4,1,3
Markus Suttner,33,Premier League,2018/2019,Defender,Brighton & Hove Albion,0,0,0,Austria,0,0,0,0,0,0,0,0,0
Marouane Fellaini,33,Premier League,2018/2019,Midfielder,Manchester United,744,217,527,Belgium,14,6,8,0,0,0,1,0,1
Martin Dúbravka,32,Premier League,2018/2019,Goalkeeper,Newcastle United,3420,1710,1710,Slovakia,38,19,19,0,0,0,0,0,0
Martin Kelly,30,Premier League,2018/2019,Defender,Crystal Palace,1110,660,450,England,13,8,5,0,0,0,0,0,0
Martín Montoya,29,Premier League,2018/2019,Defender,Brighton & Hove Albion,2166,1176,990,Spain,25,14,11,0,0,0,1,0,1
Mason Greenwood,19,Premier League,2018/2019,Midfielder,Manchester United,115,105,10,England,3,2,1,0,0,0,0,0,0
Mason Holgate,24,Premier League,2018/2019,Defender,Everton,407,270,137,England,5,3,2,0,0,0,0,0,0
Matěj Vydra,28,Premier League,2018/2019,Forward,Burnley,311,91,220,Czech Republic,13,6,7,1,1,0,1,0,1
Mateo Kovačić,26,Premier League,2018/2019,Midfielder,Chelsea,1743,968,775,Croatia,32,17,15,0,0,0,2,1,1
Mathew Ryan,28,Premier League,2018/2019,Goalkeeper,Brighton & Hove Albion,3060,1530,1530,Australia,34,17,17,0,0,0,0,0,0
Mathias Jattah-Njie Jørgensen,30,Premier League,2018/2019,Defender,Huddersfield Town,2148,1248,900,Denmark,24,14,10,3,1,2,1,0,1
Matt Butcher,23,Premier League,2018/2019,Midfielder,AFC Bournemouth,0,0,0,England,0,0,0,0,0,0,0,0,0
Matt Doherty,29,Premier League,2018/2019,Defender,Wolverhampton Wanderers,3147,1557,1590,Republic of Ireland,38,19,19,4,1,3,5,4,1
Matt Ritchie,31,Premier League,2018/2019,Midfielder,Newcastle United,2940,1557,1383,Scotland,36,19,17,2,1,1,8,2,6
Matt Targett,25,Premier League,2018/2019,Defender,Southampton,1185,483,702,England,16,7,9,1,1,0,3,2,1
Matteo Darmian,31,Premier League,2018/2019,Defender,Manchester United,443,353,90,Italy,6,5,1,0,0,0,0,0,0
Mattéo Guendouzi Olié,21,Premier League,2018/2019,Midfielder,Arsenal,2143,971,1172,France,33,14,19,0,0,0,0,0,0
Matthew Connolly,33,Premier League,2018/2019,Defender,Cardiff City,0,0,0,England,0,0,0,0,0,0,0,0,0
Matthew Lowton,31,Premier League,2018/2019,Defender,Burnley,1748,810,938,England,21,9,12,0,0,0,0,0,0
Matty Daly,20,Premier League,2018/2019,Midfielder,Huddersfield Town,73,49,24,England,2,1,1,0,0,0,0,0,0
Max Harrison Sanders,22,Premier League,2018/2019,Midfielder,Brighton & Hove Albion,0,0,0,England,0,0,0,0,0,0,0,0,0
Max Kilman,23,Premier League,2018/2019,Defender,Wolverhampton Wanderers,0,0,0,England,1,1,0,0,0,0,0,0,0
Max Meyer,25,Premier League,2018/2019,Midfielder,Crystal Palace,1414,718,696,Germany,29,18,11,1,0,1,2,0,2
Maxime Le Marchand,31,Premier League,2018/2019,Defender,Fulham,2251,1171,1080,France,26,14,12,0,0,0,1,1,0
Maya Yoshida,32,Premier League,2018/2019,Defender,Southampton,1520,800,720,Japan,17,9,8,0,0,0,1,1,0
Mesut Özil,32,Premier League,2018/2019,Midfielder,Arsenal,1741,1139,602,Germany,24,14,10,5,4,1,2,2,0
Michael Keane,28,Premier League,2018/2019,Defender,Everton,2970,1350,1620,England,33,15,18,1,0,1,2,1,1
Michael Obafemi,20,Premier League,2018/2019,Forward,Southampton,134,64,70,Republic of Ireland,6,2,4,1,0,1,1,1,0
Michail Antonio,31,Premier League,2018/2019,Midfielder,West Ham United,2099,998,1101,England,33,16,17,6,4,2,4,2,2
Michel Vorm,37,Premier League,2018/2019,Goalkeeper,Tottenham Hotspur,180,90,90,Netherlands,2,1,1,0,0,0,0,0,0
Michy Batshuayi,27,Premier League,2018/2019,Forward,Crystal Palace,756,368,388,Belgium,11,6,5,5,2,3,0,0,0
Miguel Ángel Almirón Rejala,27,Premier League,2018/2019,Midfielder,Newcastle United,763,405,358,Paraguay,10,5,5,0,0,0,0,0,0
Miguel Ángel Britos Cabrera,35,Premier League,2018/2019,Defender,Watford,185,13,172,Uruguay,3,1,2,0,0,0,0,0,0
Mohamed Diamé,33,Premier League,2018/2019,Midfielder,Newcastle United,2165,960,1205,Senegal,29,13,16,0,0,0,0,0,0
Mohamed Elneny,28,Premier League,2018/2019,Midfielder,Arsenal,381,214,167,Egypt,8,5,3,0,0,0,0,0,0
Mohamed Elyounoussi,26,Premier League,2018/2019,Midfielder,Southampton,790,393,397,Norway,16,8,8,0,0,0,0,0,0
Mohamed Salah,28,Premier League,2018/2019,Forward,Liverpool,3262,1692,1570,Egypt,38,19,19,22,13,9,8,5,3
Morgan Gibbs-White,21,Premier League,2018/2019,Midfielder,Wolverhampton Wanderers,647,426,221,England,26,13,13,0,0,0,1,1,0
Morgan Schneiderlin,31,Premier League,2018/2019,Midfielder,Everton,833,473,360,France,14,9,5,0,0,0,1,1,0
Moussa Dembele,33,Premier League,2018/2019,Midfielder,Tottenham Hotspur,516,161,355,Belgium,10,3,7,0,0,0,0,0,0
Moussa Sissoko,31,Premier League,2018/2019,Midfielder,Tottenham Hotspur,2336,1187,1149,France,29,15,14,0,0,0,3,2,1
N'Golo Kanté,30,Premier League,2018/2019,Midfielder,Chelsea,3096,1579,1517,France,36,19,17,4,2,2,4,3,1
Naby Deco Keïta,26,Premier League,2018/2019,Midfielder,Liverpool,1392,729,663,Guinea,25,14,11,2,1,1,1,1,0
Nacho Monreal,35,Premier League,2018/2019,Defender,Arsenal,1861,781,1080,Spain,22,10,12,1,1,0,3,0,3
Nampalys Mendy,28,Premier League,2018/2019,Midfielder,Leicester City,2088,1006,1082,France,31,16,15,0,0,0,0,0,0
Nathan Aké,26,Premier League,2018/2019,Defender,AFC Bournemouth,3412,1710,1702,Netherlands,38,19,19,4,3,1,0,0,0
Nathan Holland,22,Premier League,2018/2019,Midfielder,West Ham United,0,0,0,England,0,0,0,0,0,0,0,0,0
Nathan Redmond,27,Premier League,2018/2019,Midfielder,Southampton,3276,1633,1643,England,38,19,19,6,4,2,4,2,2
Nathaniel Chalobah,26,Premier League,2018/2019,Midfielder,Watford,266,67,199,England,9,3,6,0,0,0,0,0,0
Nathaniel Clyne,30,Premier League,2018/2019,Defender,AFC Bournemouth,1254,684,570,England,18,10,8,0,0,0,1,0,1
Nathaniel Mendez-Laing,28,Premier League,2018/2019,Midfielder,Cardiff City,984,442,542,England,20,9,11,4,0,4,1,1,0
Neeskens Kebano,29,Premier League,2018/2019,Midfielder,Fulham,103,74,29,Congo DR,7,5,2,0,0,0,0,0,0
Neil Leonard Dula Etheridge,31,Premier League,2018/2019,Goalkeeper,Cardiff City,3420,1710,1710,Philippines,38,19,19,0,0,0,0,0,0
Nemanja Matić,32,Premier League,2018/2019,Midfielder,Manchester United,2441,1051,1390,Serbia,28,12,16,1,1,0,0,0,0
Nicolas Otamendi,33,Premier League,2018/2019,Defender,Manchester City,1233,682,551,Argentina,18,9,9,0,0,0,0,0,0
Nikola Tavares,22,Premier League,2018/2019,Defender,Crystal Palace,0,0,0,England,0,0,0,0,0,0,0,0,0
Nnamdi Ofoborh,21,Premier League,2018/2019,Midfielder,AFC Bournemouth,0,0,0,England,0,0,0,0,0,0,0,0,0
Oleksandr Zinchenko,24,Premier League,2018/2019,Midfielder,Manchester City,1153,613,540,Ukraine,14,8,6,0,0,0,3,2,1
Oliver Skipp,20,Premier League,2018/2019,Midfielder,Tottenham Hotspur,216,191,25,England,8,6,2,0,0,0,0,0,0
Olivier Giroud,34,Premier League,2018/2019,Forward,Chelsea,832,446,386,France,27,14,13,2,1,1,4,3,1
Onyinye Wilfred Ndidi,24,Premier League,2018/2019,Midfielder,Leicester City,3299,1624,1675,Nigeria,38,19,19,2,2,0,0,0,0
Oriol Romeu,29,Premier League,2018/2019,Midfielder,Southampton,2140,1110,1030,Spain,31,16,15,1,1,0,0,0,0
Oumar Niasse,30,Premier League,2018/2019,Forward,Cardiff City,998,435,563,Senegal,18,8,10,0,0,0,0,0,0
Pablo Zabaleta,36,Premier League,2018/2019,Defender,West Ham United,2092,1216,876,Argentina,26,14,12,0,0,0,1,1,0
Pape N'Diaye Souaré,30,Premier League,2018/2019,Defender,Crystal Palace,0,0,0,Senegal,1,0,1,0,0,0,0,0,0
Pascal Groß,29,Premier League,2018/2019,Midfielder,Brighton & Hove Albion,1878,993,885,Germany,25,13,12,3,2,1,3,1,2
Patrick van Aanholt,30,Premier League,2018/2019,Defender,Crystal Palace,3198,1703,1495,Netherlands,36,19,17,3,2,1,2,0,2
Paul Dummett,29,Premier League,2018/2019,Defender,Newcastle United,1986,979,1007,Wales,26,13,13,0,0,0,0,0,0
Paul Pogba,28,Premier League,2018/2019,Midfielder,Manchester United,3011,1517,1494,France,35,18,17,13,10,3,9,4,5
Paulo Dino Gazzaniga,29,Premier League,2018/2019,Goalkeeper,Tottenham Hotspur,270,0,270,Argentina,3,0,3,0,0,0,0,0,0
Pedro Obiang,29,Premier League,2018/2019,Midfielder,West Ham United,1121,609,512,Equatorial Guinea,24,13,11,0,0,0,1,0,1
Pedro Rodriguez,33,Premier League,2018/2019,Midfielder,Chelsea,1780,958,822,Spain,31,15,16,8,6,2,2,2,0
Peter Crouch,40,Premier League,2018/2019,Forward,Burnley,86,56,30,England,6,4,2,0,0,0,0,0,0
Petr Čech,38,Premier League,2018/2019,Goalkeeper,Arsenal,585,315,270,Czech Republic,7,4,3,0,0,0,0,0,0
Phil Bardsley,35,Premier League,2018/2019,Defender,Burnley,1672,900,772,Scotland,19,10,9,0,0,0,0,0,0
Phil Jagielka,38,Premier League,2018/2019,Defender,Everton,329,95,234,England,7,3,4,1,1,0,0,0,0
Phil Jones,29,Premier League,2018/2019,Defender,Manchester United,1263,652,611,England,18,9,9,0,0,0,1,0,1
Philip Billing,24,Premier League,2018/2019,Midfielder,Huddersfield Town,2192,1106,1086,Denmark,27,13,14,2,1,1,0,0,0
Philip Foden,20,Premier League,2018/2019,Midfielder,Manchester City,327,279,48,England,13,10,3,1,1,0,0,0,0
Philippe Sandler,24,Premier League,2018/2019,Defender,Manchester City,0,0,0,Netherlands,0,0,0,0,0,0,0,0,0
Pierre-Emerick Aubameyang,31,Premier League,2018/2019,Forward,Arsenal,2731,1418,1313,Gabon,36,19,17,22,13,9,5,4,1
Pierre-Emile Højbjerg,25,Premier League,2018/2019,Midfielder,Southampton,2764,1416,1348,Denmark,31,16,15,4,2,2,3,2,1
Rachid Ghezzal,28,Premier League,2018/2019,Forward,Leicester City,738,455,283,Algeria,19,12,7,1,1,0,0,0,0
Rafael Euclides Soares Camacho,20,Premier League,2018/2019,Midfielder,Liverpool,0,0,0,Portugal,1,1,0,0,0,0,0,0,0
Raheem Sterling,26,Premier League,2018/2019,Forward,Manchester City,2777,1256,1521,England,34,16,18,17,12,5,10,6,4
Rajiv van La Parra,29,Premier League,2018/2019,Midfielder,Huddersfield Town,407,168,239,Netherlands,5,2,3,0,0,0,0,0,0
Ramadan Sobhi,24,Premier League,2018/2019,Forward,Huddersfield Town,75,30,45,Egypt,4,1,3,0,0,0,0,0,0
Raúl Alonso Jiménez Rodríguez,29,Premier League,2018/2019,Forward,Wolverhampton Wanderers,3124,1648,1476,Mexico,38,19,19,13,8,5,7,4,3
Rhys Healey,26,Premier League,2018/2019,Forward,Cardiff City,49,17,32,England,3,1,2,0,0,0,0,0,0
Ricardo Domingos Barbosa Pereira,27,Premier League,2018/2019,Defender,Leicester City,3125,1526,1599,Portugal,35,17,18,2,2,0,6,3,3
Richarlison de Andrade,23,Premier League,2018/2019,Forward,Everton,2679,1283,1396,Brazil,35,17,18,13,7,6,1,1,0
Riyad Mahrez,30,Premier League,2018/2019,Midfielder,Manchester City,1339,647,692,Algeria,27,14,13,7,1,6,4,2,2
Rob Holding,25,Premier League,2018/2019,Defender,Arsenal,807,501,306,England,10,6,4,0,0,0,0,0,0
Robbie Brady,29,Premier League,2018/2019,Midfielder,Burnley,715,390,325,Republic of Ireland,16,9,7,0,0,0,1,0,1
Robert Kenedy Nunes do Nascimento,25,Premier League,2018/2019,Midfielder,Newcastle United,1344,611,733,Brazil,25,13,12,1,0,1,1,1,0
Robert Snodgrass,33,Premier League,2018/2019,Midfielder,West Ham United,2222,1108,1114,Scotland,33,16,17,2,1,1,5,4,1
Roberto Firmino,29,Premier League,2018/2019,Forward,Liverpool,2620,1347,1273,Brazil,34,16,18,12,7,5,6,3,3
Roberto Maximiliano Pereyra,30,Premier League,2018/2019,Forward,Watford,2825,1467,1358,Argentina,33,17,16,6,5,1,1,0,1
Romain Saïss,31,Premier League,2018/2019,Midfielder,Wolverhampton Wanderers,1144,544,600,Morocco,19,8,11,2,1,1,0,0,0
Romelu Lukaku,27,Premier League,2018/2019,Forward,Manchester United,2130,982,1148,Belgium,32,16,16,12,4,8,0,0,0
Rondon,31,Premier League,2018/2019,Forward,Newcastle United,2609,1343,1266,Venezuela,32,16,16,11,6,5,7,5,2
Ross Barkley,27,Premier League,2018/2019,Midfielder,Chelsea,1241,432,809,England,27,11,16,3,1,2,5,2,3
Rúben Diogo Da Silva Neves,24,Premier League,2018/2019,Midfielder,Wolverhampton Wanderers,3009,1451,1558,Portugal,35,17,18,4,3,1,3,2,1
Rúben Gonçalo Silva Nascimento Vinagre,22,Premier League,2018/2019,Defender,Wolverhampton Wanderers,703,514,189,Portugal,17,12,5,0,0,0,0,0,0
Ruben Loftus-Cheek,25,Premier League,2018/2019,Midfielder,Chelsea,983,507,476,England,24,12,12,6,3,3,2,2,0
Rui Pedro dos Santos Patrício,33,Premier League,2018/2019,Goalkeeper,Wolverhampton Wanderers,3330,1620,1710,Portugal,37,18,19,0,0,0,0,0,0
Ryan Bennett,31,Premier League,2018/2019,Defender,Wolverhampton Wanderers,3060,1710,1350,England,34,19,15,1,1,0,0,0,0
Ryan Bertrand,31,Premier League,2018/2019,Defender,Southampton,2160,1170,990,England,24,13,11,1,1,0,0,0,0
Ryan Fraser,27,Premier League,2018/2019,Midfielder,AFC Bournemouth,3173,1605,1568,Scotland,38,19,19,7,5,2,14,5,9
Ryan Fredericks,28,Premier League,2018/2019,Midfielder,West Ham United,1085,404,681,England,15,5,10,1,1,0,0,0,0
Ryan Giles,21,Premier League,2018/2019,Midfielder,Wolverhampton Wanderers,0,0,0,England,0,0,0,0,0,0,0,0,0
Ryan Guno Babel,34,Premier League,2018/2019,Forward,Fulham,1260,668,592,Netherlands,16,9,7,5,3,2,3,3,0
Ryan Schofield,21,Premier League,2018/2019,Goalkeeper,Huddersfield Town,0,0,0,England,0,0,0,0,0,0,0,0,0
Ryan Sessegnon,20,Premier League,2018/2019,Defender,Fulham,2298,1095,1203,England,35,18,17,2,1,1,6,3,3
Sadio Mané,28,Premier League,2018/2019,Forward,Liverpool,3086,1643,1443,Senegal,36,19,17,22,18,4,1,0,1
Sam Gallagher,25,Premier League,2018/2019,Forward,Southampton,30,7,23,England,4,1,3,0,0,0,0,0,0
Sam Surridge,22,Premier League,2018/2019,Forward,AFC Bournemouth,11,0,11,England,2,0,2,0,0,0,0,0,0
Sam Vokes,31,Premier League,2018/2019,Forward,Burnley,913,455,458,Wales,20,10,10,3,2,1,0,0,0
Sam Woods,22,Premier League,2018/2019,Defender,Crystal Palace,0,0,0,England,0,0,0,0,0,0,0,0,0
Samir Nasri,33,Premier League,2018/2019,Midfielder,West Ham United,246,102,144,France,5,2,3,0,0,0,2,2,0
Sandro Ramirez,25,Premier League,2018/2019,Forward,Everton,0,0,0,Spain,0,0,0,0,0,0,0,0,0
Scott Dann,34,Premier League,2018/2019,Defender,Crystal Palace,660,360,300,England,10,4,6,0,0,0,1,0,1
Scott McTominay,24,Premier League,2018/2019,Midfielder,Manchester United,861,345,516,England,16,7,9,2,0,2,0,0,0
Sead Kolašinac,27,Premier League,2018/2019,Defender,Arsenal,1891,1127,764,Bosnia and Herzegovina,24,14,10,0,0,0,5,3,2
Séamus Coleman,32,Premier League,2018/2019,Defender,Everton,2560,1333,1227,Republic of Ireland,29,15,14,2,2,0,2,0,2
Sean Longstaff,23,Premier League,2018/2019,Midfielder,Newcastle United,688,355,333,England,9,4,5,1,1,0,0,0,0
Sean Morrison,30,Premier League,2018/2019,Defender,Cardiff City,3040,1600,1440,England,34,18,16,1,0,1,3,2,1
Sebastian Prödl,33,Premier League,2018/2019,Defender,Watford,13,0,13,Austria,1,0,1,0,0,0,0,0,0
Serge Aurier,28,Premier League,2018/2019,Defender,Tottenham Hotspur,564,136,428,Côte d'Ivoire,8,2,6,0,0,0,2,0,2
Sergio Aguero,32,Premier League,2018/2019,Forward,Manchester City,2480,1125,1355,Argentina,33,16,17,21,15,6,8,5,3
Sergio Germán Romero,34,Premier League,2018/2019,Goalkeeper,Manchester United,0,0,0,Argentina,0,0,0,0,0,0,0,0,0
Sergio Rico,27,Premier League,2018/2019,Goalkeeper,Fulham,2610,1350,1260,Spain,29,15,14,0,0,0,0,0,0
Shane Duffy,29,Premier League,2018/2019,Defender,Brighton & Hove Albion,3088,1558,1530,Republic of Ireland,35,18,17,5,2,3,1,1,0
Shane Long,34,Premier League,2018/2019,Forward,Southampton,1269,629,640,Republic of Ireland,26,15,11,5,3,2,1,1,0
Shinji Okazaki,34,Premier League,2018/2019,Forward,Leicester City,269,126,143,Japan,21,13,8,0,0,0,1,0,1
Shkodran Mustafi,28,Premier League,2018/2019,Defender,Arsenal,2617,1263,1354,Germany,31,15,16,2,0,2,0,0,0
Simon Francis,36,Premier League,2018/2019,Defender,AFC Bournemouth,1226,675,551,England,17,9,8,0,0,0,2,1,1
Simon Mignolet,33,Premier League,2018/2019,Goalkeeper,Liverpool,0,0,0,Belgium,0,0,0,0,0,0,0,0,0
Sokratis Papastathopoulos,32,Premier League,2018/2019,Defender,Arsenal,2199,1119,1080,Greece,25,13,12,1,0,1,2,2,0
Solomon March,26,Premier League,2018/2019,Midfielder,Brighton & Hove Albion,2473,1153,1320,England,35,16,19,1,1,0,5,1,4
Souleymane Bamba,36,Premier League,2018/2019,Defender,Cardiff City,2475,1260,1215,Côte d'Ivoire,28,14,14,4,2,2,1,1,0
Stefan Marius Johansen,30,Premier League,2018/2019,Midfielder,Fulham,412,130,282,Norway,12,5,7,0,0,0,0,0,0
Stefano Okaka,31,Premier League,2018/2019,Forward,Watford,22,9,13,Italy,2,1,1,0,0,0,0,0,0
Stephan Lichtsteiner,37,Premier League,2018/2019,Defender,Arsenal,940,408,532,Switzerland,14,7,7,0,0,0,0,0,0
Stephen Ward,35,Premier League,2018/2019,Defender,Burnley,230,74,156,Republic of Ireland,3,1,2,0,0,0,0,0,0
Steve Cook,29,Premier League,2018/2019,Defender,AFC Bournemouth,2787,1350,1437,England,31,15,16,1,0,1,1,0,1
Steve Mounié,26,Premier League,2018/2019,Forward,Huddersfield Town,1777,1009,768,Benin,31,16,15,2,2,0,3,1,2
Steven Davis,36,Premier League,2018/2019,Midfielder,Southampton,96,6,90,Northern Ireland,3,2,1,0,0,0,1,0,1
Steven Defour,32,Premier League,2018/2019,Midfielder,Burnley,452,172,280,Belgium,6,2,4,0,0,0,0,0,0
Stuart Armstrong,29,Premier League,2018/2019,Midfielder,Southampton,1432,469,963,Scotland,29,11,18,3,1,2,2,1,1
Sullay Kaikai,25,Premier League,2018/2019,Midfielder,Crystal Palace,0,0,0,England,0,0,0,0,0,0,0,0,0
Sung-Yeung Ki,32,Premier League,2018/2019,Midfielder,Newcastle United,1302,824,478,South Korea,18,10,8,0,0,0,1,1,0
Tahith Chong,21,Premier League,2018/2019,Forward,Manchester United,36,0,36,Netherlands,2,1,1,0,0,0,0,0,0
Terence Kongolo,27,Premier League,2018/2019,Defender,Huddersfield Town,2722,1405,1317,Netherlands,32,17,15,1,0,1,1,0,1
Theo Walcott,32,Premier League,2018/2019,Forward,Everton,2122,1114,1008,England,37,19,18,5,3,2,2,2,0
Tim Ream,33,Premier League,2018/2019,Defender,Fulham,2051,943,1108,USA,26,13,13,0,0,0,0,0,0
Timothy Eyoma,21,Premier League,2018/2019,Defender,Tottenham Hotspur,0,0,0,England,0,0,0,0,0,0,0,0,0
Timothy Fosu-Mensah,23,Premier League,2018/2019,Defender,Fulham,795,499,296,Netherlands,12,6,6,0,0,0,0,0,0
Toby Alderweireld,32,Premier League,2018/2019,Defender,Tottenham Hotspur,2924,1549,1375,Belgium,34,18,16,0,0,0,0,0,0
Tom Cairney,30,Premier League,2018/2019,Midfielder,Fulham,2198,1107,1091,Scotland,31,16,15,1,1,0,1,1,0
Tom Cleverley,31,Premier League,2018/2019,Midfielder,Watford,470,102,368,England,13,4,9,1,0,1,0,0,0
Tom Davies,22,Premier League,2018/2019,Midfielder,Everton,975,520,455,England,16,8,8,0,0,0,0,0,0
Tom Heaton,34,Premier League,2018/2019,Goalkeeper,Burnley,1710,900,810,England,19,10,9,0,0,0,0,0,0
Tom Smith,28,Premier League,2018/2019,Defender,Huddersfield Town,1141,431,710,England,15,6,9,0,0,0,0,0,0
Trent Alexander-Arnold,22,Premier League,2018/2019,Defender,Liverpool,2467,1266,1201,England,29,15,14,1,0,1,12,8,4
Troy Deeney,32,Premier League,2018/2019,Forward,Watford,2548,1298,1250,England,32,16,16,9,3,6,5,1,4
Tyias Browning,26,Premier League,2018/2019,Defender,Everton,0,0,0,England,0,0,0,0,0,0,0,0,0
Tyreke Johnson,22,Premier League,2018/2019,Defender,Southampton,0,0,0,England,1,1,0,0,0,0,0,0,0
Tyrone Mings,28,Premier League,2018/2019,Defender,AFC Bournemouth,141,7,134,England,5,2,3,0,0,0,0,0,0
Vicente Guaita,34,Premier League,2018/2019,Goalkeeper,Crystal Palace,1755,1035,720,Spain,20,12,8,0,0,0,0,0,0
Vicente Iborra De La Fuente,33,Premier League,2018/2019,Midfielder,Leicester City,226,152,74,Spain,8,3,5,0,0,0,0,0,0
Víctor Camarasa,26,Premier League,2018/2019,Midfielder,Cardiff City,2579,1267,1312,Spain,32,16,16,5,4,1,4,1,3
Victor Moses,30,Premier League,2018/2019,Midfielder,Chelsea,26,17,9,Nigeria,2,1,1,0,0,0,0,0,0
Victor Nilsson Lindelöf,26,Premier League,2018/2019,Defender,Manchester United,2602,1112,1490,Sweden,30,13,17,1,1,0,1,0,1
Victor Wanyama,29,Premier League,2018/2019,Midfielder,Tottenham Hotspur,509,302,207,Kenya,13,9,4,1,1,0,0,0,0
Viktor Gyökeres,22,Premier League,2018/2019,Forward,Brighton & Hove Albion,0,0,0,Sweden,0,0,0,0,0,0,0,0,0
Vincent Janssen,26,Premier League,2018/2019,Forward,Tottenham Hotspur,36,36,0,Netherlands,3,3,0,0,0,0,0,0,0
Vincent Kompany,34,Premier League,2018/2019,Defender,Manchester City,1223,561,662,Belgium,17,8,9,1,1,0,0,0,0
Virgil van Dijk,29,Premier League,2018/2019,Defender,Liverpool,3385,1675,1710,Netherlands,38,19,19,4,2,2,2,1,1
Wayne Hennessey,34,Premier League,2018/2019,Goalkeeper,Crystal Palace,1575,675,900,Wales,18,8,10,0,0,0,0,0,0
Wes Morgan,37,Premier League,2018/2019,Defender,Leicester City,1926,783,1143,Jamaica,22,9,13,3,1,2,0,0,0
Wesley Hoedt,27,Premier League,2018/2019,Defender,Southampton,1170,540,630,Netherlands,13,6,7,0,0,0,0,0,0
Wilfredo Daniel Caballero,39,Premier League,2018/2019,Goalkeeper,Chelsea,180,90,90,Argentina,2,1,1,0,0,0,0,0,0
Wilfried Zaha,28,Premier League,2018/2019,Midfielder,Crystal Palace,3041,1347,1694,Côte d'Ivoire,34,15,19,10,1,9,5,3,2
Will Hughes,25,Premier League,2018/2019,Midfielder,Watford,2436,1251,1185,England,32,16,16,2,1,1,4,2,2
Will Norris,27,Premier League,2018/2019,Goalkeeper,Wolverhampton Wanderers,0,0,0,England,1,1,0,0,0,0,0,0,0
Willian,32,Premier League,2018/2019,Forward,Chelsea,2108,833,1275,Brazil,32,15,17,3,2,1,6,3,3
Willy Boly,30,Premier League,2018/2019,Defender,Wolverhampton Wanderers,3169,1530,1639,France,36,17,19,4,2,2,0,0,0
Xherdan Shaqiri,29,Premier League,2018/2019,Midfielder,Liverpool,1058,538,520,Switzerland,24,12,12,6,5,1,3,0,3
Yann Valery,22,Premier League,2018/2019,Defender,Southampton,1715,1070,645,France,23,13,10,2,1,1,1,1,0
Yerry Fernando Mina González,26,Premier League,2018/2019,Defender,Everton,890,360,530,Colombia,13,6,7,1,0,1,0,0,0
Yoshinori Muto,28,Premier League,2018/2019,Forward,Newcastle United,516,180,336,Japan,17,8,9,1,0,1,0,0,0
Youri Tielemans,23,Premier League,2018/2019,Midfielder,Leicester City,1092,575,517,Belgium,13,7,6,3,2,1,4,2,2
Yves Bissouma,24,Premier League,2018/2019,Midfielder,Brighton & Hove Albion,1769,747,1022,Mali,28,13,15,0,0,0,0,0,0
Zechariah Medley,20,Premier League,2018/2019,Defender,Arsenal,0,0,0,England,0,0,0,0,0,0,0,0,0
Zeze Steven Sessegnon,20,Premier League,2018/2019,Defender,Fulham,0,0,0,England,0,0,0,0,0,0,0,0,0
Łukasz Fabiański,35,Premier League,2018/2019,Goalkeeper,West Ham United,3420,1710,1710,Poland,38,19,19,0,0,0,0,0,0
